[
  {
    "sources": [
      1
    ],
    "sink": 11,
    "interimNodes": [

    ],
    "matrix": [
      [0, 0, 3, 3, 0, 0, 0, 0, 0, 0, 0, 0],
      [0, 0, 0, 3, 3, 0, 0, 0, 0, 0, 0, 0],
      [0, 0, 0, 0, 0, 3, 0, 0, 2, 0, 0, 0],
      [0, 0, 0, 0, 0, 1, 3, 0, 0, 0, 0, 0],
      [0, 0, 0, 0, 0, 0, 1, 3, 0, 0, 0, 0],
      [0, 0, 0, 0, 0, 0, 2, 0, 0, 0, 0, 0],
      [0, 0, 0, 0, 0, 0, 0, 0, 0, 2, 2, 0],
      [0, 0, 0, 0, 0, 0, 3, 0, 0, 0, 1, 3],
      [0, 0, 0, 0, 0, 0, 0, 0, 0, 1, 0, 3],
      [0, 0, 0, 0, 0, 0, 0, 0, 0, 0, 0, 3],
      [0, 0, 0, 0, 0, 0, 0, 0, 0, 0, 0, 3],
      [0, 0, 0, 0, 0, 0, 0, 0, 0, 0, 0, 0]
    ],
    "irrelevant": [0, 2, 8]
  },
  {
	"sources": [
      0,
      1
    ],
	"sink": 11,
	"interimNodes": [

	],
	"matrix": [
      [0, 0, 3, 3, 0, 0, 0, 0, 0, 0, 0, 0],
      [0, 0, 0, 3, 3, 0, 0, 0, 0, 0, 0, 0],
      [0, 0, 0, 0, 0, 3, 0, 0, 2, 0, 0, 0],
      [0, 0, 0, 0, 0, 1, 3, 0, 0, 0, 0, 0],
      [0, 0, 0, 0, 0, 0, 1, 3, 0, 0, 0, 0],
      [0, 0, 0, 0, 0, 0, 2, 0, 0, 0, 0, 0],
      [0, 0, 0, 0, 0, 0, 0, 0, 0, 2, 2, 0],
      [0, 0, 0, 0, 0, 0, 3, 0, 0, 0, 1, 3],
      [0, 0, 0, 0, 0, 0, 0, 0, 0, 1, 0, 3],
      [0, 0, 0, 0, 0, 0, 0, 0, 0, 0, 0, 3],
      [0, 0, 0, 0, 0, 0, 0, 0, 0, 0, 0, 3],
      [0, 0, 0, 0, 0, 0, 0, 0, 0, 0, 0, 0]
    ],
    "irrelevant": []
  },
  {
    "sources": [
      0,
      1
    ],
    "sink": 11,
    "interimNodes": [
      5
    ],
    "matrix": [
      [0, 0, 3, 3, 0, 0, 0, 0, 0, 0, 0, 0],
      [0, 0, 0, 3, 3, 0, 0, 0, 0, 0, 0, 0],
      [0, 0, 0, 0, 0, 3, 0, 0, 2, 0, 0, 0],
      [0, 0, 0, 0, 0, 1, 3, 0, 0, 0, 0, 0],
      [0, 0, 0, 0, 0, 0, 1, 3, 0, 0, 0, 0],
      [0, 0, 0, 0, 0, 0, 2, 0, 0, 0, 0, 0],
      [0, 0, 0, 0, 0, 0, 0, 0, 0, 2, 2, 0],
      [0, 0, 0, 0, 0, 0, 3, 0, 0, 0, 1, 3],
      [0, 0, 0, 0, 0, 0, 0, 0, 0, 1, 0, 3],
      [0, 0, 0, 0, 0, 0, 0, 0, 0, 0, 0, 3],
      [0, 0, 0, 0, 0, 0, 0, 0, 0, 0, 0, 3],
      [0, 0, 0, 0, 0, 0, 0, 0, 0, 0, 0, 0]
    ],
    "irrelevant": []
  }
]